`````````````
`*S*`````````
`******``````
`***``*``***`
``````*****T`
``````*``***`
``````*``````
```****``````
```**G*``````
```****``````
`````````````
`````````````